11111111
10C00ME1
100000C1
1000P001
11111111
