11111111
10C000E1
10000001
1000P001
1111111
