11111111
100000E1
10000001
1000P001
11111111
